"filename", "language", "Rust", "Markdown", "TypeScript", "HTML", "JavaScript", "comment", "blank", "total"
"/Users/dragon/workspace/node/work/git_study/dart语言/Language cheatsheet.md", "Markdown", 0, 296, 0, 0, 0, 0, 42, 338
"/Users/dragon/workspace/node/work/git_study/dart语言/samples.md", "Markdown", 0, 145, 0, 0, 0, 0, 22, 167
"/Users/dragon/workspace/node/work/git_study/dart语言/where.md", "Markdown", 0, 16, 0, 0, 0, 0, 4, 20
"/Users/dragon/workspace/node/work/git_study/react/ReactFiberHooks.old.js", "JavaScript", 0, 0, 0, 0, 3044, 365, 306, 3715
"/Users/dragon/workspace/node/work/git_study/react/Scheduler.js", "JavaScript", 0, 0, 0, 0, 17, 14, 4, 35
"/Users/dragon/workspace/node/work/git_study/react/hook.md", "Markdown", 0, 119, 0, 0, 0, 0, 6, 125
"/Users/dragon/workspace/node/work/git_study/react/hooks.html", "HTML", 0, 0, 0, 84, 0, 0, 16, 100
"/Users/dragon/workspace/node/work/git_study/react/parseTemplate.html", "HTML", 0, 0, 0, 94, 0, 0, 10, 104
"/Users/dragon/workspace/node/work/git_study/react/proxy.html", "HTML", 0, 0, 0, 85, 0, 0, 6, 91
"/Users/dragon/workspace/node/work/git_study/react/queue.html", "HTML", 0, 0, 0, 52, 0, 0, 8, 60
"/Users/dragon/workspace/node/work/git_study/rust/color.rs", "Rust", 20, 0, 0, 0, 0, 0, 0, 20
"/Users/dragon/workspace/node/work/git_study/rust/guess.rs", "Rust", 16, 0, 0, 0, 0, 1, 3, 20
"/Users/dragon/workspace/node/work/git_study/rust/hanota.rs", "Rust", 29, 0, 0, 0, 0, 0, 3, 32
"/Users/dragon/workspace/node/work/git_study/rust/linked_list.rs", "Rust", 35, 0, 0, 0, 0, 10, 10, 55
"/Users/dragon/workspace/node/work/git_study/rust/main.rs", "Rust", 23, 0, 0, 0, 0, 0, 3, 26
"/Users/dragon/workspace/node/work/git_study/rust/maze.rs", "Rust", 53, 0, 0, 0, 0, 0, 7, 60
"/Users/dragon/workspace/node/work/git_study/rust/quick_sort.rs", "Rust", 8, 0, 0, 0, 0, 1, 2, 11
"/Users/dragon/workspace/node/work/git_study/rust/rust.md", "Markdown", 0, 0, 0, 0, 0, 0, 1, 1
"/Users/dragon/workspace/node/work/git_study/rust/split_whitespace.rs", "Rust", 11, 0, 0, 0, 0, 0, 2, 13
"/Users/dragon/workspace/node/work/git_study/rust/str_slice.rs", "Rust", 15, 0, 0, 0, 0, 3, 4, 22
"/Users/dragon/workspace/node/work/git_study/rust/str_split.rs", "Rust", 11, 0, 0, 0, 0, 5, 1, 17
"/Users/dragon/workspace/node/work/git_study/rust/str_to_char.rs", "Rust", 11, 0, 0, 0, 0, 0, 0, 11
"/Users/dragon/workspace/node/work/git_study/rust/test.rs", "Rust", 17, 0, 0, 0, 0, 0, 6, 23
"/Users/dragon/workspace/node/work/git_study/test.md", "Markdown", 0, 1, 0, 0, 0, 0, 1, 2
"/Users/dragon/workspace/node/work/git_study/vue源码/JSX vs template.md", "Markdown", 0, 11, 0, 0, 0, 0, 6, 17
"/Users/dragon/workspace/node/work/git_study/vue源码/Plugin.md", "Markdown", 0, 32, 0, 0, 0, 0, 1, 33
"/Users/dragon/workspace/node/work/git_study/vue源码/ast.ts", "TypeScript", 0, 0, 662, 0, 0, 54, 97, 813
"/Users/dragon/workspace/node/work/git_study/vue源码/babelUtils.ts", "TypeScript", 0, 0, 301, 0, 0, 74, 50, 425
"/Users/dragon/workspace/node/work/git_study/vue源码/codegen.ts", "TypeScript", 0, 0, 898, 0, 0, 40, 62, 1000
"/Users/dragon/workspace/node/work/git_study/vue源码/compile.ts", "TypeScript", 0, 0, 106, 0, 0, 4, 9, 119
"/Users/dragon/workspace/node/work/git_study/vue源码/errors.ts", "TypeScript", 0, 0, 154, 0, 0, 12, 17, 183
"/Users/dragon/workspace/node/work/git_study/vue源码/getter和setter.md", "Markdown", 0, 18, 0, 0, 0, 0, 0, 18
"/Users/dragon/workspace/node/work/git_study/vue源码/hoistStatic.ts", "TypeScript", 0, 0, 315, 0, 0, 27, 21, 363
"/Users/dragon/workspace/node/work/git_study/vue源码/index.ts", "TypeScript", 0, 0, 64, 0, 0, 2, 5, 71
"/Users/dragon/workspace/node/work/git_study/vue源码/noopDirectiveTransform.ts", "TypeScript", 0, 0, 2, 0, 0, 0, 2, 4
"/Users/dragon/workspace/node/work/git_study/vue源码/observe.html", "HTML", 0, 0, 0, 73, 0, 0, 13, 86
"/Users/dragon/workspace/node/work/git_study/vue源码/options.ts", "TypeScript", 0, 0, 90, 0, 0, 202, 10, 302
"/Users/dragon/workspace/node/work/git_study/vue源码/parse.ts", "TypeScript", 0, 0, 1003, 0, 0, 71, 108, 1182
"/Users/dragon/workspace/node/work/git_study/vue源码/runtimeHelpers.ts", "TypeScript", 0, 0, 87, 0, 0, 2, 3, 92
"/Users/dragon/workspace/node/work/git_study/vue源码/transform.ts", "TypeScript", 0, 0, 434, 0, 0, 45, 25, 504
"/Users/dragon/workspace/node/work/git_study/vue源码/transformElement.ts", "TypeScript", 0, 0, 778, 0, 0, 107, 59, 944
"/Users/dragon/workspace/node/work/git_study/vue源码/transformExpression.ts", "TypeScript", 0, 0, 286, 0, 0, 70, 19, 375
"/Users/dragon/workspace/node/work/git_study/vue源码/transformSlotOutlet.ts", "TypeScript", 0, 0, 101, 0, 0, 0, 13, 114
"/Users/dragon/workspace/node/work/git_study/vue源码/transformText.ts", "TypeScript", 0, 0, 93, 0, 0, 22, 5, 120
"/Users/dragon/workspace/node/work/git_study/vue源码/utils.ts", "TypeScript", 0, 0, 473, 0, 0, 30, 37, 540
"/Users/dragon/workspace/node/work/git_study/vue源码/vBind.ts", "TypeScript", 0, 0, 64, 0, 0, 4, 8, 76
"/Users/dragon/workspace/node/work/git_study/vue源码/vFor.ts", "TypeScript", 0, 0, 394, 0, 0, 26, 34, 454
"/Users/dragon/workspace/node/work/git_study/vue源码/vIf.ts", "TypeScript", 0, 0, 311, 0, 0, 30, 18, 359
"/Users/dragon/workspace/node/work/git_study/vue源码/vMemo.ts", "TypeScript", 0, 0, 37, 0, 0, 1, 3, 41
"/Users/dragon/workspace/node/work/git_study/vue源码/vModel.ts", "TypeScript", 0, 0, 127, 0, 0, 9, 13, 149
"/Users/dragon/workspace/node/work/git_study/vue源码/vOn.ts", "TypeScript", 0, 0, 136, 0, 0, 34, 12, 182
"/Users/dragon/workspace/node/work/git_study/vue源码/vOnce.ts", "TypeScript", 0, 0, 22, 0, 0, 0, 3, 25
"/Users/dragon/workspace/node/work/git_study/vue源码/vSlot.ts", "TypeScript", 0, 0, 370, 0, 0, 40, 27, 437
"/Users/dragon/workspace/node/work/git_study/vue源码/validateExpression.ts", "TypeScript", 0, 0, 50, 0, 0, 10, 7, 67
"/Users/dragon/workspace/node/work/git_study/vue源码/vue-router.md", "Markdown", 0, 49, 0, 0, 0, 0, 10, 59
"/Users/dragon/workspace/node/work/git_study/vue源码/vuex mutations actions.md", "Markdown", 0, 28, 0, 0, 0, 0, 13, 41
"/Users/dragon/workspace/node/work/git_study/vue源码/依赖追踪.md", "Markdown", 0, 37, 0, 0, 0, 0, 8, 45
"/Users/dragon/workspace/node/work/git_study/vue源码/响应性和Render Function.md", "Markdown", 0, 46, 0, 0, 0, 0, 22, 68
"/Users/dragon/workspace/node/work/git_study/vue源码/正则表达式实现最简单的模板引擎.html", "HTML", 0, 0, 0, 25, 0, 0, 1, 26
"/Users/dragon/workspace/node/work/git_study/vue源码/迷你观察者.md", "Markdown", 0, 73, 0, 0, 0, 0, 12, 85
"Total", "-", 249, 871, 7358, 413, 3061, 1315, 1220, 14487